__T__T___
_TT__TTTT
________T
TTTT__T_T
_____X___
_________
